ad 	to 
anthropo 	man 
aqua 	water 
archy 	government 
ard 	always 
audi 	hear 
auto 	self 
bell 	war 
biblio 	book 
bio 	life 
cap 	take 
cede 	go 
cent 	one hundred 
centri 	center 
cide 	kill 
cise 	cut 
cred 	believe 
dict 	say 
ician 	specialist 
itis 	inflammation 
logy 	science 
miss 	send 
neo 	new 
port 	carry 
scrib 	write 
